Sài Gòn Hôm Nay Mưa - JSOL, Hoàng Duyên
Nếu Có Kiếp Sau - Hương Ly
Hoa Nở Vô Thường - Hoài Lâm
Hồng Trần Vương Sầu Cay - Huy Vạc
Đường Tôi Chở Em Về (Lofi Version) - Bùi Trường Linh, Freak D
Sài Gòn Hôm Nay Mưa (Lofi Rain Version) - JSOL, Hoàng Duyên
Yêu Sai Người - Lý Tuấn Kiệt
Đoạn Tuyệt Nàng Đi - Phát Huy T4
Trắc Trở - X2X
Tháng Năm (Special Performance) - Soobin Hoàng Sơn, SlimV
Gặp Nhau Bên Nhau Là Ý Trời - Wind
Đong Tình - Hương Tràm
Đi Qua Thanh Xuân - NIT, Sing, Huyền Trang Lux
Người Còn Thương Ta - Phát Hồ
Chắc Họ Có Thương Em - Kiun Gia Tuấn
Đố Anh Đoán Được - Bích Phương, 1989s Entertainment
Hãy Cho Anh Biết - Phúc Bồ, Tsix Rapper
Vì Đâu Anh Rời Xa - Linh Rin
Sài Gòn Hôm Nay Mưa (Lofi Version) - JSOL, Hoàng Duyên, 1 9 6 7
Em Là Hoa Có Gai - Phương Anh, Thằng Bờm
Tình Yêu Ngủ Quên (Chill Version) - Hoàng Tôn, LyHan
Xa Tầm Với - Hoàng Anh Duy
Hiện Đại - Khắc Việt
Mê Chữ Ê Ê Ê - Jena, 24D.Bofie
Chẳng Cần Đúng Sai - Hồ Phong An
Nói Lời Hiển Nhiên - Suni Hạ Linh, Dế Choắt, Hoàng Dũng
Đơn Phương Là Tổn Thương - Thảo Wendy
Người Thương Thương Người - Tuấn Hii
Nước Mắt Đóng Băng - Hồ Quang Hiếu
Như Một Cơn Mê - Gemini Band, Bằng Cường
Nơi Đâu Có Tình Yêu Thật Sự - Lý Tuấn Kiệt
Chút Dư Âm - Hải Luân
Yêu Nhầm Thương Đau - Linh Rin
Phi Điểu Và Ve Sầu - Đan Trường
Dừng Lại Để Yêu Người Mới - Phan Ngọc Luân
Nặng Tình Cô Út - Nguyễn Đình Long
Sợ Ta Mất Nhau - Châu Khải Phong
Sợ Bắt Đầu Sợ Kết Thúc - Thanh Hà
Cách Để Quên Một Người - Lý Tuấn Kiệt
Em Là Điểm Yếu Của Anh - traitimtrongvang, 1989s Entertainment
